10
10
x x x 2 2 2 x 2 x x
x x 2 1 0 0 2 0 2 x
x 2 2 0 1 1 0 0 2 x
x 2 0 1 0 0 1 0 2 2
2 2 0 0 0 0 0 0 0 2
x 2 0 0 1 1 0 1 0 2
x 2 0 1 1 0 1 2 2 x
x 2 2 0 0 0 2 2 2 x
x x 2 2 2 1 2 2 x x
x x x 2 2 2 2 x x x 